You are exploring an abandoned mine in search of lost treasures, when you here a low rumbling sound then everything around you starts to shake. Rocks fall from the ceiling and many of the tunnels aoround you start to collapse. You should probably try to get out of here
Gold Rush
An Interactive Fiction by gbricker19
Release 1 / Serial number 190304 / Inform 7 build 6M62 (I6/v6.33 lib 6/12N) SD

Lower Shaft
The lower part of the mine where most of the valuble ores use to be. Mostly barren now with just a minecart attached to a winch and a gas can sitting next to it. The Main Shaft is to the west.

You can see the Minecart (empty), a Gas Can, a Fuel tank and Winch here.

>e
Lower Shaft

>w
Main Shaft

>w
Locker Room

>ee
That's not a verb I recognise.

>e
Main Shaft

>e
Lower Shaft

* * *

>get gas
Taken.

>pour gas in tank
The fuel tank is filled

>start winch
That's not a verb I recognise.

* * *

>pour gas in tank
The fuel tank is filled

>turn on winch
You switch Winch on.

>get in minecart
you get into the minecart
Lower Shaft (in the Minecart)
The lower part of the mine where most of the valuble ores use to be. Mostly barren now with just a minecart attached to a winch and a gas can sitting next to it. The Main Shaft is to the west.

You can see a Fuel tank and Winch here.

>e
You can't go that way.

>w
The winch slowly pulled you all the way to the main shaft, you should get out of the Mine cart and look for a way out.

Main Shaft (in the Minecart)
The main part of the shaft used for mining more common ores. To the east if the minecart rail, to the west is the old lockerooms, and to the south was where the exit used to be, but now it is blocked by a mound of rubble. Also in the room are three different sections of wall labeled Sulfur, Coal, and Potassium Nitrate.

You can see Rubble here.

>get out of minecart
You get out of the Minecart.

Main Shaft
The main part of the shaft used for mining more common ores. To the east if the minecart rail, to the west is the old lockerooms, and to the south was where the exit used to be, but now it is blocked by a mound of rubble. Also in the room are three different sections of wall labeled Sulfur, Coal, and Potassium Nitrate.

You can see the Minecart (empty) and Rubble here.

>w
Locker Room
The old room where the miners would store their belongings. lockers line the wall and a poster is hung on the wall. Also in the middle of room is a table with a mortar and pestle on it.

You can see Mortar + Pestle here.

>e
The winch slowly pulled you all the way to the main shaft, you should get out of the Mine cart and look for a way out.

Main Shaft
The main part of the shaft used for mining more common ores. To the east if the minecart rail, to the west is the old lockerooms, and to the south was where the exit used to be, but now it is blocked by a mound of rubble. Also in the room are three different sections of wall labeled Sulfur, Coal, and Potassium Nitrate.

You can see the Minecart (empty) and Rubble here.

>e
There is a pitch black empty cavern between the Lower and Main Shaft created by the earthquake, if you were to walk it would be certain death.

>w
Locker Room
The old room where the miners would store their belongings. lockers line the wall and a poster is hung on the wall. Also in the middle of room is a table with a mortar and pestle on it.

You can see Mortar + Pestle here.

>get all
Mortar + Pestle: Taken.

>x locker
You can't see any such thing.

>get pickaxe
Taken.

>e
The winch slowly pulled you all the way to the main shaft, you should get out of the Mine cart and look for a way out.

Main Shaft
The main part of the shaft used for mining more common ores. To the east if the minecart rail, to the west is the old lockerooms, and to the south was where the exit used to be, but now it is blocked by a mound of rubble. Also in the room are three different sections of wall labeled Sulfur, Coal, and Potassium Nitrate.

You can see the Minecart (empty) and Rubble here.

>mine sulfur
You chip away at the sulfur with the pickaxe and obtain a few chunks of it (now called S).

>mine potassium
You chip away at the Potassium Nitrate with the pickaxe and obtain a few chunks of it (now called KNO3).

>mine coal
You chip away at the Charcoal with the pickaxe and obtain a few chunks of it (now called C).

>combine coal with sulur
You can't see any such thing.

>combine coal with sulfur
(first taking Coal wall)
That's hardly portable.

>combine S with C
(S with C)
You Combine the two rocks to create an Accelerant!

>Combine accelerant with KNO3
You Combine the Accelerant and Oxidizer (KNO3) to creat Gunpowder!

>x rubble
A large mound of rocks completely blocking the exit, maybe you could blow a hole in the rocks.

>x gunpowder
A great tool for blowing things up

>e
There is a pitch black empty cavern between the Lower and Main Shaft created by the earthquake, if you were to walk it would be certain death.

>w
Locker Room
The old room where the miners would store their belongings. lockers line the wall and a poster is hung on the wall. Also in the middle of room is a table with a mortar and pestle on it.

>w
You can't go that way.

>x poster
How to Make Gunpowder: Combine Sulfur with Coal to create an Accelerant. Then combine  with Potassium Nitrate to create gunpowder. Great for place(ing) on rocks to blow them up!

>e
The winch slowly pulled you all the way to the main shaft, you should get out of the Mine cart and look for a way out.

Main Shaft
The main part of the shaft used for mining more common ores. To the east if the minecart rail, to the west is the old lockerooms, and to the south was where the exit used to be, but now it is blocked by a mound of rubble. Also in the room are three different sections of wall labeled Sulfur, Coal, and Potassium Nitrate.

You can see the Minecart (empty) and Rubble here.

>place gunpowder on rubble
You place the Gunpowder on the rubble and light then run around the corner. A few seconds later you hear a loud BOOM and the pathway to outside has been cleared.

>s
Earth is a room
The outside. Freedom!

You can see Rubble here.

* * *

>get gas
Taken.

>pour gas into tank
The fuel tank is filled

>get in minecart
The Minecart won't move anywhere unless the winch is turned on.

>turn on winch
You switch Winch on.

>get in minecart
you get into the minecart
Lower Shaft (in the Minecart)
You can see a Fuel tank and Winch here.

>e
You can't go that way.

>w
The winch slowly pulled you all the way to the main shaft, you should get out of the Mine cart and look for a way out.

Main Shaft (in the Minecart)

>get out o minecart
I only understood you as far as wanting to get outside.

>get out of minecart
I only understood you as far as wanting to get outside.

>get outside minecart
I only understood you as far as wanting to get outside.

>leave minecart
I only understood you as far as wanting to leave.

>get out minecart
I only understood you as far as wanting to get outside.

>exit minecart
I only understood you as far as wanting to exit.

* * *

>get gas can
Taken.

>pour gas can in fuel tanl
I only understood you as far as wanting to pour the Gas Can in the Fuel tank.

>w
There is a pitch black empty cavern between the Lower and Main Shaft created by the earthquake, if you were to walk it would be certain death.

>pour gas in tank
The fuel tank is filled

* * *

>start winch
That's not a verb I recognise.

>turn on winch
You switch Winch on.

* * *

>w
The winch slowly pulled you all the way to the main shaft, you should get out of the Mine cart and look for a way out.

Main Shaft (in the Minecart)
The main part of the shaft used for mining more common ores. To the east if the minecart rail, to the west is the old lockerooms, and to the south was where the exit used to be, but now it is blocked by a mound of rubble. Also in the room are three different sections of wall labeled Sulfur, Coal, and Potassium Nitrate.

You can see Rubble here.

>exit minecart
I only understood you as far as wanting to exit.

>leave minecart
I only understood you as far as wanting to leave.

>get out of minecart
You get out of the Minecart.

Main Shaft
The main part of the shaft used for mining more common ores. To the east if the minecart rail, to the west is the old lockerooms, and to the south was where the exit used to be, but now it is blocked by a mound of rubble. Also in the room are three different sections of wall labeled Sulfur, Coal, and Potassium Nitrate.

You can see the Minecart (empty) and Rubble here.

>x sulur
You can't see any such thing.

>x sulfur
A large part of the shaft is covered in a yellow rock that is labeled as sulfur

>x coal
A large part of the shaft is covered in a black rock that is labeled as coal

>x potassium
A large part of the shaft is covered in a white rock that is labeled as Potassium Nitrate

>w
Locker Room
The old room where the miners would store their belongings. lockers line the wall and a poster is hung on the wall.

You can see Mortar + Pestle here.

>get all
Mortar + Pestle: Taken.

>x lockers
Old Rusty lockers. One of them is slightly ajar and contains a pickaxe.

>x poster
How to Make Gunpowder: Combine Sulfur with Coal to create an Accelerant. Then combine  with Potassium Nitrate to create gunpowder. Great for place(ing) on rocks to blow them up!

>get pickaxe
Taken.

>e
There is a pitch black empty cavern between the Lower and Main Shaft created by the earthquake, if you were to walk it would be certain death.

>e
There is a pitch black empty cavern between the Lower and Main Shaft created by the earthquake, if you were to walk it would be certain death.

>w
You can't go that way.

>e
There is a pitch black empty cavern between the Lower and Main Shaft created by the earthquake, if you were to walk it would be certain death.

* * *

>get in minecart
Getting in the minecart would be no use since it is not filled with fuel.

>ignite minecart
That's not a verb I recognise.

>start minecart
That's not a verb I recognise.

>turn on minecart
You switch the ignition on.

* * *

>get in minecart
Getting in the minecart would be no use since it is not filled with fuel.

>start minecart
That's not a verb I recognise.

>switch on minecart
It isn't something you can switch.

>switch on car
You can't see any such thing.

* * *

>get in minecart
Getting in the minecart would be no use since it is not filled with fuel.

>switch on minecart
That isn't available.

>turn on minecart
That isn't available.

* * *

>get in minecart
Getting in the minecart would be no use since it is not filled with fuel.

>take gas can
Taken.

>pourgas into fuel tank
That's not a verb I recognise.

* * *

>turn on WInch
It isn't something you can switch.

>turn on winch
It isn't something you can switch.

* * *

>hehe
Main Shaft
The main part of the shaft used for mining more common ores. To the east if the minecart rail, to the west is the old lockerooms, and to the south was where the exit used to be, but now it is blocked by a mound of rubble. Also in the room are three different sections of wall labeled Sulfur, Coal, and Potassium Nitrate.

You can see Rubble here.

>s
Earth
The outside. Freedom!

You can see Rubble here.

you win

    *** The End ***

Would you like to RESTART, RESTORE a saved game, QUIT or UNDO the last command?

* * *

>pour gas into tank
You can't pour something you're not hollding

>take gas can
Taken.

>pour gas into tank
The fuel tank is filled

* * *

>turn on winch
You switch Winch on.

>x fuel tank
You see nothing special about the Fuel tank.

* * *

>pur gas can into uel tank
That's not a verb I recognise.

>puro gas can into fuel tank
That's not a verb I recognise.

>pour gas can into fuel tank
The fuel tank is filled

* * *

>purloin gunpowder
[Purloined.]

* * *

>take Gas can
Taken.

>pur gas can into fuel tank
That's not a verb I recognise.

>pour gas can into fuel tank
The fuel tank is filled

>x winch
You see nothing special about Winch.

>turn on winch
You switch Winch on.

* * *

>take gas
Taken.

>pour gas in tank
The fuel tank is filled

>turn winch on
You switch Winch on.

>get in minecart
you get into the minecart
Lower Shaft (in the Minecart)
The lower part of the mine where most of the valuble ores use to be. Mostly barren now with just a minecart attached to a winch and a gas can sitting next to it. The Main Shaft is to the west.

You can see a Fuel tank and Winch here.

>w
The winch slowly pulled you all the way to the main shaft, you should get out of the Mine cart and look for a way out.

Main Shaft (in the Minecart)
The main part of the shaft used for mining more common ores. To the east if the minecart rail, to the west is the old lockerooms, and to the south was where the exit used to be, but now it is blocked by a mound of rubble. Also in the room are three different sections of wall labeled Sulfur, Coal, and Potassium Nitrate.

You can see Rubble here.

* * *

>get out of minecart
You get out of the Minecart.

Main Shaft
The main part of the shaft used for mining more common ores. To the east if the minecart rail, to the west is the old lockerooms, and to the south was where the exit used to be, but now it is blocked by a mound of rubble. Also in the room are three different sections of wall labeled Sulfur, Coal, and Potassium Nitrate.

You can see the Minecart (empty) and Rubble here.

>w\e
That's not a verb I recognise.

>e
Lower Shaft
The lower part of the mine where most of the valuble ores use to be. Mostly barren now with just a minecart attached to a winch and a gas can sitting next to it. The Main Shaft is to the west.

You can see a Fuel tank and Winch here.

>w
There is a pitch black empty cavern between the Lower and Main Shaft created by the earthquake, if you were to walk it would be certain death.

>w
There is a pitch black empty cavern between the Lower and Main Shaft created by the earthquake, if you were to walk it would be certain death.

>undo
Lower Shaft
[Previous turn undone.]

>undo
Lower Shaft
[Previous turn undone.]

>undo
Main Shaft
[Previous turn undone.]

* * *

>take gas can
Taken.

>pour gas into tank
The fuel tank is filled
You can't pour the Gas Can.

>get in minecart
The Minecart won't move anywhere unless the winch is turned on.

* * *

>take gas can
Taken.

>take fuel tank
That's fixed in place.

>x fuel tank
 The fuel tank has no gas in it.

>use gas can on fuel tank
That's not a verb I recognise.

>put gas can in fuel tank
That can't contain things.

>fill fuel tank with gas can
Try "Pour" gas into tank"

>pour gas into tank
The fuel tank is filled

>x winch
 Now that the uel tank is full it might not be a bad idea to try and  turn  it on.

>turn on winch
You switch Winch on.

>x minecart
A heavy old minecart attached to a winch, maybe i could get out o here in this.

>w
There is a pitch black empty cavern between the Lower and Main Shaft created by the earthquake, if you were to walk it would be certain death.

>x cavern
You can't see any such thing.

>x main shaft
You can't see any such thing.

>w
There is a pitch black empty cavern between the Lower and Main Shaft created by the earthquake, if you were to walk it would be certain death.

>l
Lower Shaft
The lower part of the mine where most of the valuble ores use to be. Mostly barren now with just a minecart attached to a winch and a gas can sitting next to it. The Main Shaft is to the west.

You can see the Minecart (empty), a Fuel tank and Winch here.

>turn on winch
That's already on.

>get into minecart
you get into the minecart
Lower Shaft (in the Minecart)
The lower part of the mine where most of the valuble ores use to be. Mostly barren now with just a minecart attached to a winch and a gas can sitting next to it. The Main Shaft is to the west.

You can see a Fuel tank and Winch here.

>w
The winch slowly pulled you all the way to the main shaft, you should get out of the Mine cart and look for a way out.

Main Shaft (in the Minecart)
The main part of the shaft used for mining more common ores. To the east if the minecart rail, to the west is the old lockerooms, and to the south was where the exit used to be, but now it is blocked by a mound of rubble. Also in the room are three different sections of wall labeled Sulfur, Coal, and Potassium Nitrate.

You can see Rubble here.

>x rubble
A large mound of rocks completely blocking the exit, maybe you could blow a hole in the rocks.

>tale coal
That's not a verb I recognise.

>take coal
That's hardly portable.

>x coal
A large part of the shaft is covered in a black rock that is labeled as coal

>x sulfur
A large part of the shaft is covered in a yellow rock that is labeled as sulfur

>get out of minecart
You get out of the Minecart.

Main Shaft
The main part of the shaft used for mining more common ores. To the east if the minecart rail, to the west is the old lockerooms, and to the south was where the exit used to be, but now it is blocked by a mound of rubble. Also in the room are three different sections of wall labeled Sulfur, Coal, and Potassium Nitrate.

You can see the Minecart (empty) and Rubble here.

* * *

>w
Locker Room
The old room where the miners would store their belongings. lockers line the wall and a poster is hung on the wall. Also in the middle of room is a table with a mortar and pestle on it.

You can see Mortar + Pestle here.

>take mortar
Taken.

>x lockers
Old Rusty lockers. One of them is slightly ajar and contains a pickaxe.

>take pickaxe
Taken.

>e
The winch slowly pulled you all the way to the main shaft, you should get out of the Mine cart and look for a way out.

Main Shaft
The main part of the shaft used for mining more common ores. To the east if the minecart rail, to the west is the old lockerooms, and to the south was where the exit used to be, but now it is blocked by a mound of rubble. Also in the room are three different sections of wall labeled Sulfur, Coal, and Potassium Nitrate.

You can see the Minecart (empty) and Rubble here.

* * *

>mine sulfur
You chip away at the sulfur with the pickaxe and obtain a few chunks of it (now called S).

>mine coal
You chip away at the Charcoal with the pickaxe and obtain a few chunks of it (now called C).

>mine potassium
You chip away at the Potassium Nitrate with the pickaxe and obtain a few chunks of it (now called KNO3).

>combine c
What do you want to combine C with?

>combine c with s
(S)

>combine s with kno3
(S with KNO3)

>combine s with c
(S with C)
You Combine the two rocks to create an Accelerant!

>combine accelerant with kno3
You Combine the Accelerant and Oxidizer (KNO3) to creat Gunpowder!

>i
You are carrying:
  Gunpowder
  Pickaxe
  Mortar + Pestle
  a Gas Can

>s
(first opening Rubble)

>s
(first opening Rubble)

* * *

>s
(first opening Rubble)

>put gunpowder in rubble
That can't contain things.

>x gunpowder
A great tool for blowing things up

>w
Locker Room
The old room where the miners would store their belongings. lockers line the wall and a poster is hung on the wall. Also in the middle of room is a table with a mortar and pestle on it.

>i
You are carrying:
  Gunpowder
  Pickaxe
  Mortar + Pestle
  a Gas Can

>x poster
How to Make Gunpowder: Combine Sulfur with Coal to create an Accelerant. Then combine  with Potassium Nitrate to create gunpowder. Great for place(ing) on rocks to blow them up!

* * *

>e
The winch slowly pulled you all the way to the main shaft, you should get out of the Mine cart and look for a way out.

Main Shaft
The main part of the shaft used for mining more common ores. To the east if the minecart rail, to the west is the old lockerooms, and to the south was where the exit used to be, but now it is blocked by a mound of rubble. Also in the room are three different sections of wall labeled Sulfur, Coal, and Potassium Nitrate.

You can see the Minecart (empty) and Rubble here.

>s
(first opening Rubble)

>place gunpowder on rubble
You place the Gunpowder on the rubble and light it, then run around the corner. A few seconds later you hear a loud BOOM and the pathway to outside has been cleared.

>s
Earth is a room
The outside. Freedom!

You can see Rubble here.

you win

    *** The End ***

Would you like to RESTART, RESTORE a saved game, QUIT or UNDO the last command?

* * *

>x fuel tanl
I only understood you as far as wanting to examine the Fuel tank.

>x fuel tank
You see nothing special about the Fuel tank.

* * *

>x minecart
A heavy old minecart attached to a winch, maybe I could get out of here in this.

>x gas can
 A red gas can that is suprisingly full with fuel, maybe someone was down here more recently.

>x fuel tank
 The fuel tank has no gas in it.

>fill fuel tank with gas can
Try "Pour" gas into tank"

I beg your pardon?

>pur gas into tank
That's not a verb I recognise.

>pour gas into tank
You can't pour something you're not holding

>take gas can
Taken.

* * *

>pour gas into tank
The fuel tank is filled

>x winch
 Now that the fuel tank is full it might not be a bad idea to try and  turn  it on.

>turn on winch
You switch Winch on.

>get in cart
You can't see any such thing.

I beg your pardon?

>x cart
You can't see any such thing.

>x minecart
A heavy old minecart attached to a winch, maybe I could get out of here in this.

>w
There is a pitch black empty cavern between the Lower and Main Shaft created by the earthquake, if you were to walk it would be certain death.

>e
You can't go that way.

>get in minecart
you get into the minecart
Lower Shaft (in the Minecart)
The lower part of the mine where most of the valuble ores use to be. Mostly barren now with just a minecart attached to a winch and a gas can sitting next to it. The Main Shaft is to the west.

You can see a Fuel tank and Winch here.

* * *

>x rubble
A large mound of rocks completely blocking the exit, maybe you could blow a hole in the rocks.

>e
Lower Shaft (in the Minecart)
The lower part of the mine where most of the valuble ores use to be. Mostly barren now with just a minecart attached to a winch and a gas can sitting next to it. The Main Shaft is to the west.

You can see a Fuel tank and Winch here.

>w
The winch slowly pulled you all the way to the main shaft, you should get out of the Mine cart and look for a way out.

Main Shaft (in the Minecart)
The main part of the shaft used for mining more common ores. To the east if the minecart rail, to the west is the old lockerooms, and to the south was where the exit used to be, but now it is blocked by a mound of rubble. Also in the room are three different sections of wall labeled Sulfur, Coal, and Potassium Nitrate.

You can see Rubble here.

>w
Locker Room (in the Minecart)
The old room where the miners would store their belongings. lockers line the wall and a poster is hung on the wall. Also in the middle of room is a table with a mortar and pestle on it.

You can see Mortar + Pestle here.

>x mortar
a small mortar and pestle that could be used for  combining  to things together.

>take mortar
Taken.

>e
The winch slowly pulled you all the way to the main shaft, you should get out of the Mine cart and look for a way out.

Main Shaft (in the Minecart)
The main part of the shaft used for mining more common ores. To the east if the minecart rail, to the west is the old lockerooms, and to the south was where the exit used to be, but now it is blocked by a mound of rubble. Also in the room are three different sections of wall labeled Sulfur, Coal, and Potassium Nitrate.

You can see Rubble here.

>s
you can't find your way throught the rubble

>x sulfur
A large part of the shaft is covered in a yellow rock that is labeled as sulfur

>take sulfur
That's hardly portable.

>x coal
A large part of the shaft is covered in a black rock that is labeled as coal

>x nitrate
You can't see any such thing.

>x potassium nitrate
I only understood you as far as wanting to examine Potassium wall.

>yes
That was a rhetorical question.

>w
Locker Room (in the Minecart)
The old room where the miners would store their belongings. lockers line the wall and a poster is hung on the wall. Also in the middle of room is a table with a mortar and pestle on it.

>x lockers
Old Rusty lockers. One of them is slightly ajar and contains a pickaxe.

>open lockers
It isn't something you can open.

>open rusty locker
You can't see any such thing.

>take pickaxe
Taken.

>e
The winch slowly pulled you all the way to the main shaft, you should get out of the Mine cart and look for a way out.

Main Shaft (in the Minecart)
The main part of the shaft used for mining more common ores. To the east if the minecart rail, to the west is the old lockerooms, and to the south was where the exit used to be, but now it is blocked by a mound of rubble. Also in the room are three different sections of wall labeled Sulfur, Coal, and Potassium Nitrate.

You can see Rubble here.

>use pickaxe on sulfur
That's not a verb I recognise.

>pickaxe sulfur
That's not a verb I recognise.

>take sulfur with pickaxe
I only understood you as far as wanting to take Sulfur wall.

>take sulfur wall
That's hardly portable.

>w
Locker Room (in the Minecart)
The old room where the miners would store their belongings. lockers line the wall and a poster is hung on the wall. Also in the middle of room is a table with a mortar and pestle on it.

>x pickaxe
An old rusty pickaxe but it might be able to still mine some rock.

>e
The winch slowly pulled you all the way to the main shaft, you should get out of the Mine cart and look for a way out.

Main Shaft (in the Minecart)
The main part of the shaft used for mining more common ores. To the east if the minecart rail, to the west is the old lockerooms, and to the south was where the exit used to be, but now it is blocked by a mound of rubble. Also in the room are three different sections of wall labeled Sulfur, Coal, and Potassium Nitrate.

You can see Rubble here.

>mine sulfur
You chip away at the sulfur with the pickaxe and obtain a few chunks of it (now called S).

>take S
(S)
You already have that.

>mine coal
You chip away at the Charcoal with the pickaxe and obtain a few chunks of it (now called C).

>mine nitrate
You can't see any such thing.

>mine potassium nitrate
I only understood you as far as wanting to mine Potassium wall.

>mine pottassium
You can't see any such thing.

>mine potassium
You chip away at the Potassium Nitrate with the pickaxe and obtain a few chunks of it (now called KNO3).

>combine KNO3 with C
nothing happens

>combine S with C
(S with C)
You Combine the two rocks to create an Accelerant!

>combine Accelerant with KNO3
You Combine the Accelerant and Oxidizer (KNO3) to creat Gunpowder!

>use gunpowder on rubble
That's not a verb I recognise.

>w
Locker Room (in the Minecart)
The old room where the miners would store their belongings. lockers line the wall and a poster is hung on the wall. Also in the middle of room is a table with a mortar and pestle on it.

>x poster
How to Make Gunpowder: Combine Sulfur with Coal to create an Accelerant. Then combine  with Potassium Nitrate to create gunpowder. Great for place(ing) on rocks to blow them up!

>e
The winch slowly pulled you all the way to the main shaft, you should get out of the Mine cart and look for a way out.

Main Shaft (in the Minecart)
The main part of the shaft used for mining more common ores. To the east if the minecart rail, to the west is the old lockerooms, and to the south was where the exit used to be, but now it is blocked by a mound of rubble. Also in the room are three different sections of wall labeled Sulfur, Coal, and Potassium Nitrate.

You can see Rubble here.

>place gunpowder on rubble
You place the Gunpowder on the rubble and light it, then run around the corner. A few seconds later you hear a loud BOOM and the pathway to outside has been cleared.

>s
Earth is a room (in the Minecart)
The outside. Freedom!

You can see Rubble here.

* * *

>x winch
You see nothing special about Winch.

>x fuel tank
 The fuel tank has no gas in it.

>take gas
Taken.